冥龙锁天阵=Minh Long Tỏa Thiên Trận
十方修罗经=Thập Phương Tu La Kinh
卢西塔尼亚=Lô Tây Tháp Ni Á
吞妖镇天诀=Thôn Yêu Trấn Thiên Quyết
唐朝贵公子=Đường Triều Quý Công Tử
困仙锁魔阵=Khốn Tiên Tỏa Ma Trận
天水真书令=Thiên Thủy Chân Thư Lệnh
姓唐名 嫮=họ Đường Danh Mỹ
宝刹妖山中=trong Bảo Sát Yêu Sơn
对帝天来说=đối với Đế Thiên mà nói
幽冥掌灯使=U Minh Chưởng Đăng Sử
明月山水图=Minh Nguyệt Sơn Thủy Đồ
每日的拒绝=Mỗi Nhật Cự Tuyệt
狱山大荒泽=Ngục Sơn Đại Hoang Trạch
绝命沉舟丹=Tuyệt Mệnh Trầm Chu Đan
赤明九天图=Xích Minh Cửu Thiên Đồ
追月飞星锤=Truy Nguyệt Phi Tinh Chuy
青灵山山脚=Thanh Linh Sơn Sơn Cước
魔兽盖浇饭=Ma Thú Cái Kiêu Phạn
七十二变=Thất Thập Nhị Biến
万象真人=Vạn Tượng Chân Nhân
三戒大师=Tam Giới Đại Sư
乌特雷德=Ô Đặc Lôi Đức
亚历山大=Á Lịch Sơn Đại
京畿道了=Kinh Kỳ Đạo
京畿道来=Kinh Kỳ Đạo
仙缘大会=Tiên Duyên Đại Hội
元神道人=Nguyên Thần Đạo Nhân
分筋错骨=Phân Cân Thác Cốt
刑法之刃=Hình Pháp Chi Nhận
北山黑虎=Bắc Sơn Hắc Hổ
单重斩击=Đan Trọng Trảm Kích
卡里巴德=Tạp Lý Ba Đức
又石田斋=Hựu Thạch Điền Trai
唯一仙尊=Duy Nhất Tiên Tôn
夏芒紫山=Hạ Mang Tử Sơn
大夏王都=Đại Hạ vương đô
大悲天牢=Đại Bi Thiên Lao
大荒古纪=Đại Hoang Cổ Kỷ
天叱妖皇=Thiên Sất Yêu Hoàng
天地之目=Thiên Địa Chi Mục
天选古神=Thiên Tuyển Cổ Thần
宇文小策=Vũ Văn Tiểu Sách
封禁大阵=Phong Cấm Đại Trận
小千剑阵=Tiểu Thiên Kiếm Trận
少炎公子=Thiếu Viêm công tử
引灵敕令=Dẫn Linh sắc lệnh
弗洛伦斯=Phất Lạc Luân Tư
归元秘史=Quy Nguyên Bí Sử
怪诞之刃=Quái Đản Chi Nhận
惜月郡主=Tích Nguyệt quận chúa
愤怒打击=Phẫn Nộ Đả Kích
成功主神=Thành Công Chủ Thần
旗开得胜=Kỳ Khai Đắc Thắng
无念阎帝=Vô Niệm Diêm Đế
日月后期=Nhật Nguyệt hậu kỳ
昭月正神=Chiêu Nguyệt Chính Thần
普光无上=Phổ Quang Vô Thượng
月珠明台=Nguyệt Châu Minh Thai
木传真人=Mộc Truyền Chân Nhân
松洲大人=Tùng Châu đại nhân
桔宁姑娘=Kết Ninh cô nương
殿才仙人=Điện Tài Tiên Nhân
水火莲花=Thủy Hỏa Liên Hoa
沁 sè=Thấm Sắc
沧江真人=Thương Giang Chân Nhân
河流之汪=Hà Lưu Chi Uông
流星火陨=Lưu Tinh Hỏa Vẫn
浊黄巨蛇=Trọc Hoàng Cự Xà
浮云仙人=Phù Vân Tiên Nhân
海肖盟主=Hải Tiếu Minh Chủ
清风道友=Thanh Phong đạo hữu
火翼妖王=Hỏa Dực Yêu Vương
狂乱宝石=Cuồng Loạn Bảo Thạch
玄天剑罡=Huyền Thiên Kiếm Cương
玄天道诀=Huyền Thiên Đạo Quyết
玄机老祖=Huyền Ky Lão Tổ
白首妖师=Bạch Thủ Yêu Sư
白鹤漩涡=Vòng Xoáy Bạch Hạc
盐田酒肆=Diêm Điền Tửu Tứ
盘古道友=Bàn Cổ đạo hữu
盛宴宝石=Thịnh Yến Bảo Thạch
破日神箭=Phá Nhật Thần Tiến
神之排骨=Thần Chi Bài Cốt
神匠之光=Thần Tượng Chi Quang
神州锤王=Thần Châu Chuy Vương
秦国内部=bên trong Tần quốc
精神鞭挞=Tinh Thần Tiên Thát
紫云师妹=Tử Vân sư muội
紫府修士=Tử Phủ Tu Sĩ
紫气东来=Tử Khí Đông Lai
纪宁公子=Kỷ Ninh công tử
纯阳真仙=Thuần Dương Chân Tiên
肃大先生=Túc Đại Tiên Sinh
蛮薛太子=Man Tiết Thái Tử
血脉索仇=Huyết Mạch Tác Cừu
补神提神=Bổ Thần Đề Thần
西西域风=Tây Tây Vực Phong
许离真人=Hứa Ly Chân Nhân
赤明九天=Xích Minh Cửu Thiên
超级黄蜂=Siêu Cấp Hoàng Phong
这些纹理=những hoa văn này
这份尊严=phần uy nghiêm này
道之域境=Đạo Chi Vực Cảnh
邋遢真人=Lạp Tháp Chân Nhân
那么淡然=lạnh nhạt như vậy
那么阔绰=xa xỉ như vậy
邺王殿下=Nghiệp Vương điện hạ
酒池肉林=Tửu Trì Nhục Lâm
野兽光环=Dã Thú Quang Hoàn
野火小钟=Dã Hỏa Tiểu Chung
金色纹路=đường vân màu vàng
铁骨棘兽=Thiết Cốt Cức Thú
长安姑娘=Trường An cô nương
阳神虚焰=Dương Thần Hư Diễm
雅利安人=người Nhã Lợi An
雎华仙人=Sư Hoa Tiên Nhân
雪羽道人=Tuyết Vũ Đạo Nhân
震爆战锤=Chấn Bạo Chiến Chuy
青灯古佛=Thanh Đăng Cổ Phật
风翼遁法=Phong Dực Độn Pháp
食砂凶鱼=Thực Sa Hung Ngư
黄毛大熊=hoàng mao đại hùng
黑暗之魂=Hắc Ám Chi Hồn
黑白学宫=Hắc Bạch Học Cung
黑石真人=Hắc Thạch Chân Nhân
龙鲸大妖=Long Kình Đại Yêu
七头牛=Thất Đầu Ngưu
万道宫=Vạn Đạo Cung
三夜城=Tam Dạ Thành
三尺剑=Tam Xích Kiếm
中恒国=Trung Hằng Quốc
九耀人=Cửu Diệu Nhân
于冬野=Vu Đông Dã
云 杋=Vân Mộc
井台卞=Tỉnh Thai Biện
何修行=Hà Tu Hành
余温酒=Dư Ôn Tửu
侯破云=Hầu Phá Vân
偃月宗=Yển Nguyệt Tông
兄弟盟=Huynh Đệ Minh
克洛伊=Khắc Lạc Y
入山体=Nhập Sơn Thể
全知堂=Toàn Tri Đường
八天王=Bát Thiên Vương
公羊屠=Công Dương Đồ
公车右=Công Xa Hữu
刘自武=Lưu Tự Vũ
剑齿虎=Kiếm Xỉ Hổ
北冥剑=Bắc Minh kiếm
北山氏=Bắc Sơn thị
北山狐=Bắc Sơn Hồ
十方劫=Thập Phương Kiếp
千绝坊=Thiên Tuyệt Phường
华 渃=Hoa Quang
南平江=Nam Bình Giang
南院落=Nam Viện rơi
博贝特=Bác Bối Đặc
卜罗师=Bặc La Sư
卡哈儿=Tạp Cáp Nhi
卡哈尔=Tạp Cáp Nhĩ
古之远=Cổ Chi Viễn
古应龙=Cổ Ứng Long
叫鬼枭=Khiếu Quỷ Kiêu
叶抚边=Diệp Phủ Biên
启泰门=Khải Thái Môn
吴文可=Ngô Văn Khả
吴暮秋=Ngô Mộ Thu
周饶国=Chu Nhiêu Quốc
呼延豹=Hô Duyên Báo
唐春来=Đường Xuân Lai
固城县=Cố Thành Huyện
在天条=tại Thiên Điều
塔尼亚=Tháp Ni Á
大荒泽=Đại Hoang Trạch
大雪山=Đại Tuyết sơn
大龙窟=Đại Long quật
天宝山=Thiên Bảo Sơn
天星堡=Thiên Tinh Bảo
天极烈=Thiên Cực Liệt
天相子=Thiên Tương Tử
天规军=Thiên Quy Quân
天门关=Thiên Môn Quan
太阳井=Thái Dương Tỉnh
奥斯曼=Áo Tư Mạn
妙仪峰=Diệu Nghi Phong
宁交城=Ninh Giao Thành
宁河叔=Ninh Hà thúc
宇文成=Vũ Văn Thành
安澶侯=An Thiền Hầu
安澶郡=An Thiền quận
宋泰生=Tống Thái Sinh
宝安山=Bảo An Sơn
尉迟雪=Uất Trì Tuyết
少炎农=Thiếu Viêm Nông
少炎氏=Thiếu Viêm thị
尤德斯=Vưu Đức Tư
展天翼=Triển Thiên Dực
岳执明=Nhạc Chấp Minh
巫太平=Vu Thái Bình
巴布洛=Ba Bố Lạc
巴恩斯=Ba Ân Tư
庇修斯=Tí Tu Tư
应龙卫=Ứng Long Vệ
弃聂嘁=Khí Niếp Thích
张焕文=Trương Hoán Văn
张飞痕=Trương Phi Ngân
归云寺=Quy Vân Tự
归元宫=Quy Nguyên Cung
归威远=Quy Uy Viễn
往西天=đi Tây Thiên
徐陷阵=Từ Hãm Trận
德米特=Đức Mễ Đặc
恩格尔=Ân Cách Nhĩ
托代斯=Thác Đại Tư
摘星手=Trích Tinh Thủ
文明师=Văn Minh Sư
方寸山=Phương Thốn Sơn
方木匣=Phương Mộc Hạp
昆仑诀=Côn Luân Quyết
明月山=Minh Nguyệt Sơn
是宁国=Thị Ninh Quốc
曹仲宗=Tào Trọng Tông
望月宗=Vọng Nguyệt Tông
木子朔=Mộc Tử Sóc
李九木=Lý Cửu Mộc
李斯特=Lý Tư Đặc
李有信=Lý Hữu Tín
李生海=Lý Sinh Hải
李甲儿=Lý Giáp Nhi
李芳芳=Lý Phương Phương
杨大眼=Dương Đại Nhãn
林月如=Lâm Nguyệt Như
柳金娥=Liễu Kim Nga
梁上燕=Lương Thượng Yến
水莹莹=Thủy Oánh Oánh
水虫人=Thủy Trùng Nhân
永真王=Vĩnh Chân Vương
沈福成=Trầm Phúc Thành
法相境=Pháp Tương Cảnh
洞子启=Động Tử Khải
洞神灵=Động Thần Linh
浅飞轮=Thiển Phi Luân
漠烟城=Mạc Yên Thành
灭普峰=Diệt Phổ Phong
炎天倾=Viêm Thiên Khuynh
焚海老=Phần Hải lão
玄彬泉=Huyền Bân Tuyền
玉不尘=Ngọc Bất Trần
玉人偶=Ngọc Nhân Ngẫu
王凯丽=Vương Khải Lệ
王晓平=Vương Hiểu Bình
王永刚=Vương Vĩnh Cương
白叶山=Bạch Diệp Sơn
白得碾=Bạch Đắc Niễn
白水泽=Bạch Thủy Trạch
白水澜=Bạch Thủy Lan
白沙城=Bạch Sa Thành
白瓶儿=Bạch Bình Nhi
百道阁=Bách Đạo các
相柳方=Tương Liễu Phương
秦子舟=Tần Tử Chu
空青蛇=Không Thanh Xà
纪九火=Kỷ Cửu Hỏa
纪留真=Kỷ Lưu Chân
维塔斯=Vitas
缥缈城=Phiếu Miểu Thành
罗伯特=La Bá Đặc
罗帐内=trong la trướng
群星院=Quần Tinh Viện
羽流王=Vũ Lưu Vương
翼蛇湖=Dực Xà Hồ
耶律选=Gia Luật Tuyển
肖云飞=Tiếu Vân Phi
胡小仙=Hồ Tiểu Tiên
苍梧鹫=Thương Ngô Thứu
苍河水=Thương Hà Thủy
苏伯泞=Tô Bá Nính
菅麻生=Gian Ma Sinh
萨克尔=Tát Khắc Nhĩ
葛长龄=Cát Trường Linh
蒙契国=Mông Khế Quốc
薛宁远=Tiết Ninh Viễn
虎字营=Hổ Tự Doanh
血戮仙=Huyết Lục Tiên
行星带=Hành Tinh Đái
袁白玉=Viên Bạch Ngọc
观音婢=Quan Âm Tỳ
论道殿=Luận Đạo Điện
谢静黎=Tạ Tĩnh Lê
贴护国=Thiếp Hộ Quốc
费将军=Phí Tướng Quân
赖文盛=Lại Văn Thịnh
赵浩燃=Triệu Hạo Nhiên
起源山=Khởi Nguyên Sơn
达洛人=Đạt Lạc Nhân
连子清=Liên Tử Thanh
金柳铁=Kim Liễu Thiết
金玉珍=Kim Ngọc Trân
金银花=Kim Ngân Hoa
铁木占=Thiết Mộc Chiêm
铁皮人=Thiết Bì Nhân
阮腾渊=Nguyễn Đằng Uyên
阳利军=Dương Lợi Quân
阴流剑=Âm Lưu Kiếm
陆长生=Lục Trường Sinh
雪龙山=Tuyết Long Sơn
雾坝星=Vụ Bá Tinh
顾晓峰=Cố Hiểu Phong
鹧鸪烈=Chá Cô Liệt
黄子才=Hoàng Tử Tài
龛罗道=Ham La Đạo
万象=Vạn Tượng
三寿=Tam Thọ
临北=Lâm Bắc
丹霄=Đan Tiêu
义聚=Nghĩa Tụ
乔敏=Kiều Mẫn
乔治=Kiều Trì
九妖=Cửu Yêu
九莲=Cửu Liên
仆月=Phó Nguyệt
仙墟=Tiên Khư
伊布=Y Bố
伊比=Y Bỉ
余佳=Dư Giai
佥事=Thiêm Sự
做墙=Tố Tường
元洲=Nguyên Châu
元神=Nguyên Thần
先天=Tiên Thiên
兰登=Lan Đăng
兴业=Hưng Nghiệp
冬神=Đông Thần
冰冬=Băng Đông
凯丽=Khải Lệ
凯儿=Khải Nhi
分殿=Phân Điện
刘腾=Lưu Đằng
利尔=Lợi Nhĩ
别介=Biệt Giới
加布=Gia Bố
华野=Hoa Dã
华顺=Hoa Thuận
卡尔=Tạp Nhĩ
厉断=Lệ Đoạn
古边=Cổ Biên
吉恩=Cát Ân
吞天=Thôn Thiên
周谋=Chu Mưu
咬火=Giảo Hỏa
唐天=Đường Thiên
唐洞=Đường Động
唐贼=Đường tặc
圣诞=Thánh Đản
圣象=Thánh Tượng
塔克=Tháp Khắc
夏芒=Hạ Mang
夜凯=Dạ Khải
大夏=Đại Hạ
大汗=Đại Hãn
大燕=Đại Yên
大锤=Đại Chuy
天仙=Thiên Tiên
天古=Thiên Cổ
天捕=Thiên Bộ
天涯=Thiên Nhai
子朔=Tử Sóc
孙战=Tôn Chiến
孙秋=Tôn Thu
孙辨=Tôn Biện
孤城=Cô Thành
孤驼=Cô Đà
宁交=Ninh Giao
宇字=Vũ Tự
安伯=An bá
安澶=An Thiền
小钥=Tiểu Thược
小鹿=Tiểu Lộc
小龙=Tiểu Long
少炎=Thiếu Viêm
尹蕊=Duẫn Nhị
巨狮=Cự Sư
巫江=Vu Giang
巫铁=Vu Thiết
巴格=Ba Cách
巴特=Ba Đặc
布兰=Bố Lan
常仑=Thường Luân
广水=Nghiễm Thủy
库林=Khố Lâm
应龙=Ứng Long
庞张=Bàng Trương
康利=Khang Lợi
廖伯=Liêu Bá
延王=Duyên Vương
建木=Kiến Mộc
张东=Trương Đông
影蛇=Ảnh Xà
徐芙=Từ Phù
御影=Ngự Ảnh
德容=Đức Dung
悍霖=Hãn Lâm
托托=Thác Thác
拉蒙=Lạp Mông
拓伐=Thác Phạt
括善=Quát Thiện
敖貅=Ngao Hưu
敦钧=Đôn Quân
断筋=Đoạn Cân
施恩=Thi Ân
昌建=Xương Kiến
明月=Minh Nguyệt
明见=Minh Kiến
春冉=Xuân Nhiễm
昭理=Chiêu Lý
晓风=Hiểu Phong
晶莹=Tinh Oánh
曹雁=Tào Nhạn
木传=Mộc Truyền
本州=Bản Châu
李丢=Lý Đâu
李鑫=Lý Hâm
杨程=Dương Trình
林御=Lâm Ngự
果刚=Quả Cương
梅琳=Mai Lâm
武州=Vũ Châu
殿才=Điện Tài
比利=Billy
水部=Thủy Bộ
汗帝=Hãn Đế
沃顿=Ốc Đốn
沈宇=Thẩm Vũ
沧江=Thương Giang
泓森=Hoằng Sâm
泼江=Bát Giang
流杯=Lưu Bôi
浩亭=Hạo Đình
海州=Hải Châu
渡厄=Độ Ách
湛泸=Trạm Lô
滚开=Cổn Khai
潘总=Phan Tổng
灵卿=Linh Khanh
灵昭=Linh Chiêu
焕采=Hoán Thải
焦木=Tiêu Mộc
燕山=Yến Sơn
燕真=Yến Chân
燧石=Toại Thạch
狗场=Cẩu Tràng
王九=Vương Cửu
琼芳=Quỳnh Phương
瓦拉=Ngõa Lạp
甄末=Chân Mạt
田飞=Điền Phi
白马=Bạch Mã
百微=Bách Vi
皇府=Hoàng phủ
盛城=Thịnh Thành
祖炁=Tổ Khí
神链=Thần Liên
神魔=Thần Ma
离子=Ly Tử
离骚=Ly Tao
秋星=Thu Tinh
秦纲=Tần Cương
穷奇=Cùng Kỳ
米拉=Mễ Lạp
米萝=Mễ La
紫府=Tử Phủ
红宫=Hồng Cung
纪宁=Kỷ Ninh
纪氏=Kỷ thị
纱罗=Sa La
绣儿=Tú Nhi
缉事=Tập Sự
罗布=La Bố
罗林=La Lâm
罗达=La Đạt
羌狄=Khương Địch
翠心=Thúy Tâm
翼蛇=Dực Xà
老宅=Lão Trạch
聂野=Niếp Dã
聂隐=Nhiếp Ẩn
胡佼=Hồ Giảo
胡叙=Hồ Tự
花雨=Hoa Vũ
芸儿=Vân Nhi
茶锦=Trà Cẩm
莫盟=Mạc Minh
莱克=Lai Khắc
莲娜=Liên Na
萧倩=Tiêu Thiến
萧才=Tiêu Tài
萧机=Tiêu Cơ
萧衡=Tiêu Hành
落英=Lạc Anh
落衣=Lạc Y
蓝姑=Lam Cô
蕴神=Uẩn Thần
薇娜=Vi Na
虚焰=Hư Diễm
蚁后=Nghĩ Hậu
血火=Huyết Hỏa
裴邃=Bùi Thúy
西罗=Tây La
许离=Hứa Ly
车行=Xa Hành
达伦=Đạt Luân
连皎=Liên Giảo
迷翼=Mê Dực
通窍=Thông Khiếu
造神=Tạo Thần
道祖=Đạo Tổ
邋遢=Lạp Tháp
邹彬=Trâu Bân
金帐=Kim Trướng
金海=Kim Hải
银杏=Ngân Hạnh
长亭=Trường Đình
阔海=Khoát Hải
阿桑=A Tang
附生=Phụ Sinh
陈暗=Trần Ám
雎华=Sư Hoa
雪宁=Tuyết Ninh
雪莉=Tuyết Lỵ
雪龙=Tuyết Long
霍丁=Hoắc Đinh
霹雳=Phích Lịch
鞍子=An Tử
顾雪=Cố Tuyết
风翼=Phong Dực
马革=Mã Cách
驼涧=Đà Giản
高单=Cao Đan
鬃戈=Tông Qua
鬼爪=Quỷ Trảo
鹭湖=Lộ Hồ
黄凯=Hoàng Khải
黄波=Hoàng Ba
黑雕=Hắc Điêu
龙城=Long Thành
龙蜃=Long Thận
刑=Hình
悦=Duyệt
大千宝树=Đại Thiên bảo thụ
有喜=Hữu Hỉ
大毛球=Đại Mao Cầu
信仰古经=Tín Ngưỡng Cổ Kinh
大国小商=Đại Quốc Tiểu Thương
镇尸钉=Trấn Thi Đinh
夺身钉=Đoạt Thân Đinh
风系妖元=Yêu Nguyên hệ Phong
郑羡仙=Trịnh Tiện Tiên
刘青羽=Lưu Thanh Vũ
毒焰=Độc Diễm
本命蛊虫=Bản Mệnh cổ trùng
这蛊虫=cổ trùng này
自带观众经=Tự Đái Quan Chúng Kinh
解丹说=Giải Đan Thuyết
剑门关=Kiếm Môn quan
化灵境=Hóa Linh cảnh
紫色铃=Tử sắc linh
这魏黛眉=Ngụy Đại Mi này
暗霜之吟=Ám Sương chi ngâm
观气术=Quan Khí thuật
应水郡=Ứng Thủy quận
极地焰光旗=Cực Địa Diễm Quang Kỳ
鬼金羊=Quỷ Kim Dương
上清观=Thượng Thanh quan
隐气诀=Ẩn Khí quyết
龙王的傲娇日常=Long Vương Đích Ngạo Kiều Nhật Thường
白雀=Bạch Tước
秋横空=Thu Hoành Không
李寒灯=Lý Hàn Đăng
灵相境=Linh Tương cảnh
一叶法舟=Nhất Diệp Pháp Chu
飞蜈洞=Phi Ngô động
汀鹤=Đinh Hạc
尺简素=Xích Giản Tố
观礼台=đài xem lễ
吕修缘=Lữ Tu Duyên
砚心=Nghiễn Tâm
童越=Đồng Việt
太阴白虬=Thái Âm Bạch Cầu
化星道卷=Hóa Tinh đạo quyển
龙象混元=Long Tượng Hỗn Nguyên
鸟族=Điểu tộc
雀凤王=Tước Phượng vương
虎龙王=Hổ Long vương
断识尸坨林=Đoạn Thức Thi Đà Lâm
